1111111111111
1001000C00001
1000011111001
1000110E00001
1111111111111