1111111111111
1001000000EC1
1000011111011
1P00110000001
1111111111111