1111111111111
100100C000001
1000011111001
1P00110000E01
1111111111111