1111111111111
10010000000C1
1000011111001
1P0011E000001
10001C0000011
1000110000C01
111C000001111
1111111111111