1111111111111
11111111111C1
1111111111111
1P1111E111111
1111111111111