1111111111111111111111
10M000000000010C000001
10000101001000001010E1
1010010010101010001001
1000P0000C00C000000001
1111111111111111111111